80 157 196 202 233
1 26 44 48 57 63 102 143 163 192 246
27 52 72 92 140 144 156 159 220 248 250 252
13 31 38 60 76 91 107 116 128 130 171 177 204 209 226
5 32 45 47 70 77 85 97 115 132 137 168 180 184 223 245
6 36 41 53 98 99 108 117 135 139 146 166 183 185 206 251
19 46 65 83 86 110 114 121 145 158 165 178 188 211 232 236
2 9 14 22 29 30 39 40 71 84 95 109 127 129 162 164 176
4 7 10 11 20 37 50 66 73 100 119 124 125 133 182 230 237
15 24 61 62 64 106 112 131 160 189 195 219 234 242 247 249 254
0 8 55 75 104 122 150 174 181 186 191 200 216 222 224 229 238 239
3 16 18 35 74 79 81 120 154 167 173 190 194 201 205 210 253 255
28 56 68 69 87 105 111 175 198 203 212 214 218 221 228 231 240 243
12 21 33 42 59 78 88 103 123 126 134 138 142 170 179 207 213 225 244
34 43 54 67 82 89 90 94 96 101 113 136 151 153 172 193 208 215 241
17 23 25 49 51 58 93 118 141 147 148 149 152 155 161 169 187 197 199 217 227 235

