2 9 14 19 22 29 30 39 40 46 65 71 83 84 86 95 109 110 114 121 127 129 145 158 162 164 165 176 178 188 211 232 236
0 3 8 16 18 35 55 74 75 79 81 104 120 122 150 154 167 173 174 181 186 190 191 194 200 201 205 210 216 222 224 229 238 239 253 255
28 34 43 54 56 67 68 69 80 82 87 89 90 94 96 101 105 111 113 136 151 153 157 172 175 193 196 198 202 203 208 212 214 215 218 221 228 231 233 240 241 243
5 12 17 21 23 25 27 32 33 42 45 47 49 51 52 58 59 70 72 77 78 85 88 92 93 97 103 115 118 123 126 132 134 137 138 140 141 142 144 147 148 149 152 155 156 159 161 168 169 170 179 180 184 187 197 199 207 213 217 220 223 225 227 235 244 245 248 250 252
1 4 6 7 10 11 13 15 20 24 26 31 36 37 38 41 44 48 50 53 57 60 61 62 63 64 66 73 76 91 98 99 100 102 106 107 108 112 116 117 119 124 125 128 130 131 133 135 139 143 146 160 163 166 171 177 182 183 185 189 192 195 204 206 209 219 226 230 234 237 242 246 247 249 251 254

